Title    |Twinkle Twinkle (Wandering Melody Remix)
Subtitle |
Artist   |Sometimes Mozart
Cover Art|
Notes    |

P1   |4K
P1/T1|Vl|MuseScore_General.sf2 Patch=8 Gain=0.3
P2   |4K
P2/T1|Vl|MuseScore_General.sf2 Patch=12 Gain=0.15
P2/T2|Vl|MuseScore_General.sf2 Patch=12 Gain=0.1

 600|1   |    |      |    | A-3  |      
    |2   |    |      |    |      |      
    |3   |    |      |    | E-3  |      
    |4   |    |      |    |      |      
    |5   |    |      |    | A-3  |      
    |6   |    |      |    |      |      
    |7   |    |      |    | E-3  |      
    |8   |    |      |    |      |      
    |1   | o  |oA-4  | o  |oA-3  |      
    |2   |o   |oE-4  |  ox|oC#4  |xE-4  
    |3   | o  |oA-4  |o   |oE-3  |      
    |4   |  o |oC#5  |  ox|oC#4  |xE-4  
    |5   |   o|oE-5  | o  |oA-3  |      
    |6   | o  |oA-4  |  ox|oC#4  |xE-4  
    |7   |  o |oC#5  |o   |oE-3  |      
    |8   |   o|oE-5  |  ox|oC#4  |xE-4  
    |1   | o  |oF#5  | o  |oF#3  |      
    |2   |o   |oA-4  |  ox|oA-3  |xD-4  
    |3   | o  |oF#5  |o   |oD-3  |      
    |4   |   o|oA-5  |  ox|oA-3  |xD-4  
    |5   |  o |oE-5  | o  |oA-3  |      
    |6   |    |      |  ox|oC#4  |xE-4  
    |7   | o  |oA-4  |o   |oE-3  |      
    |8   |o   |oE-4  |  ox|oC#4  |xE-4  
    |1   |   o|oD-5  | o  |oF#3  |      
    |2   |o   |oF#4  |  ox|oA-3  |xD-4  
    |3   | o  |oA-4  |o   |oD-3  |      
    |4   |   o|oD-5  |  ox|oA-3  |xD-4  
    |5   |  o |oC#5  | o  |oA-3  |      
    |6   |o   |oE-4  |  ox|oC#4  |xE-4  
    |7   | o  |oA-4  |o   |oE-3  |      
    |8   |   o|oC#5  |  ox|oC#4  |xE-4  
    |1   |  o |oB-4  | o  |oF#3  |      
    |2   | o  |oA-4  |  ox|oB-3  |xD-4  
    |3   | o  |oA-4  |o   |oD-3  |      
    |4   |   o|oC#5  |  ox|oB-3  |xD-4  
    |5   |  o |oB-4  | o  |oE-3  |      
    |6   |    |      |  ox|oG#3  |xB-3  
    |7   |o   |oE-4  |o   |oB-2  |      
    |8   |    |      |  ox|oG#3  |xB-3  
    |1   | o  |oA-4  | o  |oA-3  |      
    |2   |o   |oE-4  |  ox|oC#4  |xE-4  
    |3   | o  |oA-4  |o   |oE-3  |      
    |4   |  o |oC#5  |  ox|oC#4  |xE-4  
    |5   |   o|oE-5  | o  |oA-3  |      
    |6   | o  |oA-4  |  ox|oC#4  |xE-4  
    |7   |  o |oC#5  |o   |oE-3  |      
    |8   |   o|oE-5  |  ox|oC#4  |xE-4  
    |1   | o  |oF#5  | o  |oF#3  |      
    |2   | o  |oF#5  |  ox|oA-3  |xD-4  
    |.500|o   |oF-5  |    |      |      
    |3   | o  |oF#5  |o   |oD-3  |      
    |4   |   o|oA-5  |  ox|oA-3  |xD-4  
    |5   |  o |oG#5  | o  |oG#3  |      
    |6   |  o |oF#5  |  ox|oC#4  |xE-4  
    |.333|   o|oG#5  |    |      |      
    |.667|  o |oF#5  |    |      |      
    |7   | o  |oE-5  |o   |oE-3  |      
    |8   |o   |oA-4  |  ox|oC#4  |xE-4  
    |1   |   o|oD-5  | o  |oF#3  |      
    |2   |o   |oF#4  |  ox|oA-3  |xD-4  
    |3   | o  |oA-4  |o   |oD-3  |      
    |4   |   o|oD-5  |  ox|oA-3  |xD-4  
    |5   |  o |oC#5  | o  |oA-3  |      
    |6   |o   |oE-4  |  ox|oC#4  |xE-4  
    |7   | o  |oA-4  |o   |oE-3  |      
    |8   |   o|oC#5  |  ox|oC#4  |xE-4  
    |1   |  o |oB-4  | o  |oF#3  |      
    |2   |  o |oB-4  |  ox|oB-3  |xD-4  
    |.500|   o|oC#5  |    |      |      
    |3   |  o |oB-4  |o   |oE-3  |      
    |4   | o  |oA-4  |  ox|oG#3  |xB-3  
    |5   | o  |oA-4  | o  |oA-3  |      
    |6   |    |      |  ox|oC#4  |xE-4  
    |7   | o  |oA-4  |o   |oE-3  |      
    |8   |  o |oC#5  |  ox|oC#4  |xE-4  
    |1   |   o|oE-5  | o  |oA-3  |      
    |2   |o   |oE-4  |  ox|oC#4  |xE-4  
    |3   | o  |oA-4  |o   |oE-3  |      
    |4   |  o |oC#5  |  ox|oC#4  |xE-4  
    |5   |   o|oD-5  | o  |oF#3  |      
    |6   |o   |oF#4  |  ox|oA-3  |xD-4  
    |7   | o  |oA-4  |o   |oD-3  |      
    |8   |  o |oB-4  |  ox|oA-3  |xD-4  
    |1   |   o|oC#5  | o  |oA-3  |      
    |2   |o   |oE-4  |  ox|oC#4  |xE-4  
    |3   | o  |oA-4  |o   |oE-3  |      
    |4   |   o|oC#5  |  ox|oC#4  |xE-4  
    |5   |  o |oB-4  | o  |oE-3  |      
    |6   |o   |oE-4  |  ox|oG#3  |xB-3  
    |7   | o  |oG#4  |o   |oB-2  |      
    |8   |  o |oB-4  |  ox|oG#3  |xB-3  
    |1   |   o|oE-5  | o  |oA-3  |      
    |2   |o   |oE-4  |  ox|oC#4  |xE-4  
    |3   | o  |oC#5  |o   |oE-3  |      
    |4   |   o|oE-5  |  ox|oC#4  |xE-4  
    |5   |  o |oD-5  | o  |oF#3  |      
    |6   |o   |oF#4  |  ox|oA-3  |xD-4  
    |7   | o  |oA-4  |o   |oD-3  |      
    |8   |   o|oD-5  |  ox|oA-3  |xD-4  
    |1   |  o |oC#5  | o  |oA-3  |      
    |2   |o   |oE-4  |  ox|oC#4  |xE-4  
    |3   | o  |oA-4  |o   |oE-3  |      
    |4   |   o|oC#5  |  ox|oC#4  |xE-4  
    |5   |  o |oB-4  | o  |oE-3  |      
    |6   |o   |oE-4  |  ox|oG#3  |xB-3  
    |7   |   o|oD-5  |o   |oB-2  |      
    |8   | o  |oB#4  |  ox|oG#3  |xB-3  
    |1   |  o |oC#5  | o  |oA-3  |      
    |2   |o   |oE-4  |  ox|oC#4  |xE-4  
    |3   | o  |oA-4  |o   |oE-3  |      
    |4   |  o |oC#5  |  ox|oC#4  |xE-4  
    |5   |   o|oE-5  | o  |oA-3  |      
    |6   | o  |oA-4  |  ox|oC#4  |xE-4  
    |7   |  o |oC#5  |o   |oE-3  |      
    |8   |   o|oE-5  |  ox|oC#4  |xE-4  
    |1   | o  |oF#5  | o  |oF#3  |      
    |2   | o  |oF#5  |  ox|oA-3  |xD-4  
    |.500|o   |oF-5  |    |      |      
    |3   | o  |oF#5  |o   |oD-3  |      
    |4   |   o|oA-5  |  ox|oA-3  |xD-4  
    |5   |  o |oG#5  | o  |oG#3  |      
    |6   |  o |oF#5  |  ox|oC#4  |xE-4  
    |.333|   o|oG#5  |    |      |      
    |.667|  o |oF#5  |    |      |      
    |7   | o  |oE-5  |o   |oE-3  |      
    |8   |o   |oA-4  |  ox|oC#4  |xE-4  
    |1   |   o|oD-5  | o  |oF#3  |      
    |2   |o   |oF#4  |  ox|oA-3  |xD-4  
    |3   | o  |oA-4  |o   |oD-3  |      
    |4   |   o|oD-5  |  ox|oA-3  |xD-4  
    |5   |  o |oC#5  | o  |oA-3  |      
    |6   |o   |oE-4  |  ox|oC#4  |xE-4  
    |7   | o  |oA-4  |o   |oE-3  |      
    |8   |   o|oC#5  |  ox|oC#4  |xE-4  
    |1   |  o |oB-4  | o  |oF#3  |      
    |2   |  o |oB-4  |  ox|oB-3  |xD-4  
    |.500|   o|oC#5  |    |      |      
    |3   |  o |oB-4  |o   |oE-3  |      
    |4   | o  |oA-4  |  ox|oG#3  |xB-3  
    |5   | o  |oA-4  | o  |oA-3  |      
    |6   |    |      |o   |oE-3  |      
    |7   | o  |oA-4  | o  |oA-2  |      
    |8   |    |      |    |      |      
